111111111111111111111111
101010001010100010000001
100000000000000000000001
100000000000000000000001
100100100100100100000001
1101000101C1C10001000001
110010010000010010000001
110010000000010010000001
100000000000000000000001
100000000000000000000001
100000000000000000000001
100000001000000000000001
100000010100000000000001
100000000000000000000001
110011111000000000000001
11001000000000P000000001
110010000000000000000001
110010000000010010000001
110010000000010010000001
110010000000010010000001
110010000000010010000001
110010000000010010000001
100000000000000000000001
100000000000000000000001
100000000000000000000001
100000000000000000000001
100000000000000000000001
111111111111111111111111