111111111111111111111111
101010001010100010000001
100000000000000000000001
100000000000000000000001
100100100100100100000001
110100010101010001000001
110010010000010010000001
110010000000010010000001
100000000000000000000001
100000000000000000000001
100000000000000000000001
100000001000000000000001
10000001P100000000000001
100000000000000000000001
110011111000010010000001
110010000000010010000001
110010000000010010000001
110010000000010010000001
110010000000010010000001
110010000000010010000001
110010000000010010000001
110010000000010010000001
100000000000000000000001
100000000000000000000001
100000000000000000000001
100000000000000000000001
100000000000000000000001
111111111111111111111111